1 1 1 1 1 1 1 1 1 1 1 1 1 1 1 1 1 1 1 1 1 1 1 1
1 2 2 2 2 2 3 2 2 2 2 3 2 2 2 2 3 2 2 2 2 2 7 1
1 2 3 3 3 2 3 2 3 3 3 2 3 3 3 2 3 2 3 3 3 3 3 1
1 2 3 2 3 2 3 2 3 2 3 2 3 2 3 2 3 2 3 2 3 2 2 1
1 2 3 2 3 2 2 2 2 2 3 6 2 2 2 2 3 2 2 2 2 3 2 1
1 2 5 3 3 3 3 3 2 2 3 3 3 3 3 3 3 3 2 2 3 3 3 1
1 2 2 2 2 2 2 3 2 2 2 2 2 2 2 2 2 3 2 2 2 2 3 1
1 3 3 3 3 2 3 3 2 3 3 3 3 3 3 3 2 3 2 3 3 3 3 1
1 3 2 2 3 2 2 2 2 2 2 3 2 2 2 3 2 2 2 2 2 3 3 1
1 3 3 2 3 3 3 2 3 3 3 3 3 3 2 3 2 3 3 3 2 3 2 1
1 3 2 2 2 2 2 2 2 2 2 2 3 1 2 2 2 2 2 2 2 3 2 1
1 3 2 3 3 3 3 3 3 3 3 2 3 3 3 2 2 4 3 3 3 3 2 1
1 7 2 2 2 2 2 2 2 2 2 2 2 2 2 2 2 2 2 2 2 2 2 1
1 3 3 3 3 3 3 3 3 3 3 3 3 3 3 3 3 3 3 3 3 2 3 1
1 1 1 1 1 1 1 1 1 1 1 1 1 1 1 1 1 1 1 1 1 1 1 1
